WWWWWWWWWWWWWWWWWWWWWWWWWWWWWWWWWWWW
W                                  W
T                                  T
T  G                               T
T  G                               T
T  G                               T
T                                  T
T                                  T
W                                  W
WWWWWWWWWWWWWWWWWWWWWWWWWWWWWWWWWWWW
